{
    "presets": {
        "disco": {
            "regions": {
                "0": [
                    [ 1, 2, 0, 0, 0, 0, 0, 0, 0, 0, -2, -1 ],
                    [ 1, 2, 0, 0, 0, 0, 0, 0, 0, 0, -2, -1 ],
                    [ 1, 2, 0, 0, 0, 0, 0, 0, 0, 0, -2, -1 ],
                    [ 1, 2, 0, 0, 0, 0, 0, 0, 0, 0, -2, -1 ]
                ],
                "1": [
                    [ 1, 2, 0, 0, 7, 0, 0, 0, 0, 0, -2, -1 ],
                    [ 1, 2, 0, 0, 0, 0, 0, 0, 0, 0, -2, -1 ],
                    [ 1, 2, 0, 0, 0, 0, 0, 0, 0, 0, -2, -1 ],
                    [ 1, 2, 0, 0, 0, 0, 0, 0, 8, 0, -2, -1 ]
                ],
                "2": [
                    [ 1, 2, 0, 0, 0, 0, 0, 0, 0, 0, -2, -1 ],
                    [ 1, 2, 0, 0, 0, 0, 7, 0, 0, 0, -2, -1 ],
                    [ 1, 2, 0, 0, 3, 3, 3, 3, 0, 0, -2, -1 ],
                    [ 1, 2, 0, 0, 0, 0, 0, 0, 0, 0, -2, -1 ]
                ],
                "3": [
                    [ 1, 2, 0, 0, 0, 0, 0, 0, 0, 0, -6, -1 ],
                    [ 1, 2, 0, 0, 0, 0, 0, 0, 0, 0, -6, -1 ],
                    [ 1, 2, 0, 0, 0, 0, 0, 0, 0, 8, -2, -1 ],
                    [ 1, 2, 4, 4, 4, 0, 0, 0, 0, 0, -2, -1 ],
                    [ 1, 2, 0, 0, 0, 0, 0, 0, 0, 0, -2, -1 ],
                    [ 1, 2, 0, 0, 7, 0, 0, 3, 3, 3, -2, -1 ],
                    [ 1, 2, 0, 0, 0, 0, 0, 0, 0, 0, -2, -1 ],
                    [ 1, 2, 2, 0, 0, 0, 0, 0, 0, 0, -2, -1 ],
                    [ 1, 6, 0, 0, 3, 3, 3, 0, 0, 0, -2, -1 ],
                    [ 1, 6, 0, 0, 0, 0, 0, 0, 0, 0, -2, -1 ]
                ],
                "4": [
                    [ 1, 2, 0, 0, 0, 0, 7, 0, 0, 0, -2, -1 ],
                    [ 1, 2, 3, 3, 3, 0, 0, 0, 0, 0, -2, -1 ],
                    [ 1, 2, 0, 0, 0, 3, 3, 3, 3, 3, -2, -1 ]
                ],
                "5": [
                    [ 1, 2, 4, 4, 4, 4, 4, 4, 4, 0, -2, -1 ],
                    [ 1, 2, 0, 0, 0, 0, 0, 0, 0, 0, -2, -1 ],
                    [ 1, 2, 0, 0, 0, 4, 4, 0, 0, 0, -2, -1 ]
                ],
                "6": [
                    [ 1, 2, 0, 0, 0, 0, 0, 3, 3, 0, -2, -1 ],
                    [ 1, 2, 0, 0, 0, 0, 0, 0, 0, 0, -2, -1 ],
                    [ 1, 2, 4, 4, 4, 4, 4, 0, 0, 0, -6, -1 ],
                    [ 1, 6, 0, 8, 0, 0, 0, 0, 0, 0, -6, -1 ],
                    [ 1, 6, 0, 0, 0, 0, 0, 0, 0, 0, -6, -1 ],
                    [ 1, 6, 0, 0, 3, 0, 0, 0, 0, 0, -2, -1 ],
                    [ 1, 6, 0, 0, 0, 0, 3, 0, 3, 0, -2, -1 ],
                    [ 1, 2, 0, 0, 0, 0, 0, 3, 0, 8, -6, -1 ],
                    [ 1, 2, 0, 0, 0, 0, 0, 0, 0, 0, -6, -1 ],
                    [ 1, 6, 0, 3, 3, 7, 3, 3, 0, 3, -2, -1 ],
                    [ 1, 6, 0, 0, 0, 0, 0, 0, 0, 0, -2, -1 ],
                    [ 1, 2, 4, 4, 0, 0, 0, 0, 0, 0, -2, -1 ]
                ]
            },
            "dificults": {
                "easy": [ 0, 1, 2 ],
                "normal": [ 3 ],
                "hard": [ 4 ],
                "insane": [ 5, 6 ]
            }
        },
        "rock": {
            "regions": {
            },
            "dificults": {
                "easy": [ 0 ],
                "normal": [ 0 ],
                "hard": [ 0 ],
                "insane": [ 0 ]
            }
        }
    }
}